+------------------------------------+------------------------+-------------------------------------------+
|                                    |  |                  |  |                                           |
|                                    |  |                  |  |                                           |
|                                    +  ------+      +------  +                                           |
|                                    |        |      |        |                                           |
|                                    |        +------+        |                                           |
|                                    |                        |                                           |
|                                    |        +-Lab--+        |                                           |
|                                    |        |      |        |                                           |
|                                    +--------+      +--------+                                           |
|                                     @ @ @ @          @ @ @ @                                            |
|                                                                                                         |
|                                                                                                         |
|                                                                              +-----------------+        |
|                                                                              |                 |        |
|                                                                        @ @ @ +-+               |        |
|                                                                                |               |        |
|                                                                                Home            |        |
|                                                                                |               |        |
|                                                                        @ @ @ +-+               |        |
|                                                                              |                 |        |
|                                                                              +-----------------+        |
|                                                                                                         |
|                                                                                                         |
|       @   @   @   @   @   @                                                  @   @   @   @   @   @      |
|       +-------------------+                                                  +--------------------+     |
|       |                   |                                                  |                    |     |
|       |                   |                                                  |                    |     |
|       |                   |@ @                                           @ @ |                    |     |
|       |                   |                                                  |                    |     |
|       |                   |@ @                                           @ @ |                    |     |
|       |                   |                                                  |                    |     |
|       |                   |                                                  |                    |     |
|       +-------------------+                                                  +--------------------+     |
|       @   @   @   @   @   @                                                  @   @   @   @   @   @      |
|                                                                                                         |
|                                                                                                         |
|                                                                                                         |
|                                                                                                         |
|                                                                                                         |
|                                                                                                         |
+---------------------------------------------------------------------------------------------------------+
